56666666666666666666666666666666666666666666666666666666666666666666666666666665
50000000000000000000000000000000000000000000000000000000000000000000000000000005
50000000000000000000000000000000000000900000000000000000000000000000000000000005
50000000000000000000000000000000000000100000000000000000000000000000000000000005
50000000000000000000000000000000000000100000000000000000000000000000000000000005
50000000000000000000000000000000000000100000000000000000000000000000000000000005
50000000000000000000000000000000000000100000000000000000000000000000000000000005
50000000000000000000000000000000000000100000000000000000000000000000000000000005
50000000000000000000000000000000000000100000000000000000000000000000000000000005
50000000000000000000000000000000000000100000000000000000000000000000000000000005
50000000000000000000000000000000000000100000000000000000000000000000000000000005
50000000000000000000000000000000000000100000000000000000000000000000000000000005
50000000000000000000000000000000000000100000000000000000000000000000000000000005
50000000000000001111111111113111111411111900000000000000000000000000000000000005
50000000000000001000000000000000000010000000000000000000000000000000000000000005
50000000000000001000000000000000000010000000000000000000000000000000000000000005
50000000000000001000000000000000000310000000000000000000000000000000000000000005
50000000000000001000000000000000000100000000000000000000000000000000000000000005
50000000000000001000000000000000000100000000000000000000000000000000000000000005
50000000000000001000000000000000000111111111111111119100000000000000000000000005
50000000000000001000000000000000000100000000000000000100000000000000000000000005
50000000000000003000000000000000000100000000000000000100000000000000000000000005
50000000000000001000000000000000000100000000000000000100000000000000000000000005
50000000000000001000000000000000000100000000000000000100000000000000000000000005
50000000000000001111111111111111119300000000000000000100000000000000000000000005
50000000000000000000000000000000000100000000000000000110000000000000000000000005
50000000000000000000000000000000000100000000000000000010000000000000000000000005
50000000000000000000000000000000000100000004000000000010000000000000000000000005
50000000000000000000000000000000000100000003000000000010000000000000000000000005
50000000000000000000000000000000000100000001000000000010000000000000000000000005
50000000000000000000000000000000000100000001000000000010000000000000000000000005
50000000000000000000000000000000000391111111111111111110000000000000000000000005
50000000000000000000000000000000000100000000000000000000000000000000000000000005
50000000000000000000000000000000000100000000000000000000000000000000000000000005
50000000000000000000000000000000000100000000000000000000000000000000000000000005
50000000000000000000000000000000000110000000000000000000000000000000000000000005
50000000000000000000000000000000000010000000000000000000000000000000000000000005
50000000000000000000000000000000113111000000000000000000000000000000000000000005
50000000000000000000000000000000400001000000000000000000000000000000000000000005
56666666666666666666666666666666666682766666666666666666666666666666666666666665
